0909090909090909090909090909090909090909
0909090909090909090909090909090909090909
0909090909090909090909090909090909090909
0909090909090909090909090909090909090909
0909090957515151515151515151515609090909
0909090957020202020202020202025609090909
0909090957020202020202020202025609090909
0909090957020202020202020202025609090909
0909090957020202020202020202025609090909
0909090909090909090909090909090909090909
0909090909090909090909090909090909090909
0909090909090909090909090909090909090909
0909090909090909090909090909090909090909
0909090909090909090909090909090909090909
0909090909090909090909090909090909090909
0909090909090909090909090909090909090909
0909090909090909090909090909090909090909
0909090909090909090909090909090909090909
0909090909090909090909090909090909090909
0909090909090909090909090909090909090909
@bed_hut+166+161+oven+313+118+kitchen_stuff+365+121+table_hut+367+203+box+415+150+box+445+151+box+433+130+