0909090909090909090909090909090909090909
0909090909090909090909090909090909090909
0909090909090909090909090909090909090909
0909095751515151595151585151515156090909
09090957020202020D02020C0202020256090909
09090957020202020D02020C0202020256090909
09090957020202020D02020E0A0A0A0A56090909
090909570A0A0A0A0F0202020202020256090909
09090957020202020202020A0A0A0A0A56090909
090909570A0A0A0A0202020C0202020256090909
090909570202020D0202020C0202020256090909
090909570A0A0A0F0A0A0A0E0A0A0A0A56090909
0909090909090909090909090909090909090909
0909090909090909090909090909090909090909
0909090909090909090909090909090909090909
0909090909090909090909090909090909090909
0909090909090909090909090909090909090909
0909090909090909090909090909090909090909
0909090909090909090909090909090909090909
0909090909090909090909090909090909090909
@bed_double+439+113+bed_house+408+277+mirror+386+90+fireplace+173+77+portrait+137+96+dresser+442+248+throne+145+169+