0909090909090909090909090909090909090909
0909090909090909090909090909090909090909
0909090909090909090909090909090909090909
0909090909090909090909090909090909090909
0909095751515151595151585151515156090909
09090957020202020D02020C0202020256090909
09090957020202020D02020C0202020256090909
090909570A0B0A0A0F02020E0A0A0A0A56090909
0909095702020202020202020202020256090909
090909570A0A0A0A0A0B0A0A0A0A0A0A56090909
0909095702020202020202020202020256090909
0909095702020202020202020202020256090909
090909570A0A0A0A0A0A0A0A0A0A0A0A56090909
0909090909090909090909090909090909090909
0909090909090909090909090909090909090909
0909090909090909090909090909090909090909
0909090909090909090909090909090909090909
0909090909090909090909090909090909090909
0909090909090909090909090909090909090909
0909090909090909090909090909090909090909
@@oven+132+120+kitchen_stuff+171+123+kitchen_cabinet+214+107+bookshelf+131+285+table_hut+181+182+box+370+153+box+406+151+box+385+132+box+383+162+wine+386+146+barrel+485+151+barrel+456+189+wine_cabinet+405+285+stairs_right+469+260+beer+456+156+