20+20!
0909090909090909090909090909090909090909
0909090909090909090909090909090909090909
0909090909090909090909090909090909090909
0909090909090909090909090909090909090909
0909095751515151515153515151515156090909
0909095702020202020202020202020256090909
0909095702020202020202020202020256090909
0909095702020202020202020202020256090909
0909095702020202020202020202020256090909
0909095702020202020202020202020256090909
0909095702020202020202020202020256090909
0909095702020202020202020202020256090909
0909095702020202020202020202020256090909
0909090909090909090909090909090909090909
0909090909090909090909090909090909090909
0909090909090909090909090909090909090909
0909090909090909090909090909090909090909
0909090909090909090909090909090909090909
0909090909090909090909090909090909090909
0909090909090909090909090909090909090909
@oven+132+120+kitchen_stuff+171+123+kitchen_cabinet+214+107+bookshelf+131+285+table_hut+181+182+box+370+153+box+406+151+box+385+132+box+383+162+wine+386+146+barrel+485+151+barrel+456+189+wine_cabinet+405+285+beer+456+156!
#main_world+306+153+120+700!
~ItemBestower+nice_folk+400+385+Chickens are up in here eating our food.Kill one chicken and claim your rewards.+5+3+0!