30+30!
090909090909090909090909090909090909090909090909090909090909
090909090909090909090909090909090909090909090909090909090909
090909090909090909090909090909090909090909090909090909090909
090909090909090909090909090909090909090909090909090909090909
090909090303030303030303030A0B0B0C03030303030303030309090909
090909090303030303030303030A0B0B0C03030303030303030309090909
090909090303030303030303030A0B0B0C03030303030303030309090909
090909090303030303030303030A0B0B0C03030303030303030309090909
090909090303030303030303030A0B0B0C03030303030303030309090909
090909090303030303030365650607070865650303030303030309090909
090909090303030303030303030A0B0B0C03030303030303030309090909
090909090303030303030303030A0B0B0C03030303030303030309090909
090909090303030303030303030A0B0B0C03030303030303030309090909
090909090303030303030303030A0B0B0C03030303030303030309090909
090909090303030303030303030A0B0B0C03030303030303030309090909
090909090303030303030303030A0B0B0C03030303030303030309090909
090909090303030303030303030A0B0B0C03030303030303030309090909
090909090303030303030303030A0B0B0C03030303030303030309090909
090909090303030303030303030A0B0B0C03030303030303030309090909
090909090303030303030303030303030303030303030303030309090909
090909090303030303030303030303030303030303030303030309090909
090909090303030303030303030303030303030303030303030309090909
090909090303030303030303030303030303030303030303030309090909
090909090303030303030303030303030303030303030303030309090909
090909090909090909090909090903030909090909090909090909090909
090909090909090909090909090909090909090909090909090909090909
090909090909090909090909090909090909090909090909090909090909
090909090909090909090909090909090909090909090909090909090909
090909090909090909090909090909090909090909090909090909090909
090909090909090909090909090909090909090909090909090909090909
@throne+450+135+castle_1_1+121+14+castle_1_2+128+14+castle_1_3+832+128+castle_1_4+128+301+castle_1_4+608+301+castle_1_5+128+768+castle_1_6+505+768+castle_1_7+448+800+castle_1_8+377+629+castle_1_9+576+629+castle_1_10+384+629+castle_1_10+512+629+