50+30!
0909090909090909090909090909090909090909090909090909090909090909090909090909090909090909090909090909
0909090909090909090909090909090909090909090909090909090909090909090909090909090909090909090909090909
0909090909090909090909090909090909090909090909090909090909090909090909090909090909090909090909090909
0909090909090966666666666666666666666666666666666666666666666666666666660909090909090909090909090909
0909090909090966666666666666666666666666666666666666666666666666666666660909090909090909090909090909
0909090909090966666666666666666666666666666666666666666666666666666666660909090909090909090909090909
0909090909090966666666666666666666666666666666666666666666666666666666660909090909090909090909090909
0909090909090966666666666666666666666666666666666666666666666666666666660909090909090909090909090909
0909090909090966666666666666666666666666666666666666666666666666666666660909090909090909090909090909
0909090909090966666666666666666666666666666666666666666666666666666666660909090909090909090909090909
0909090909090966666666666666666666666666666666666666666666666666666666660909090909090909090909090909
0909090909090966666666666666666666666666666666666666666666666666666666666666666666666666660909090909
0909090909090966666666666666666666666666666666666666666666666666666666666666666666666666660909090909
0909090909666666666666666666666666666666666666666666666666666666666666666666666666666666660909090909
0909090909666666666666666666666666666666666666666666666666666666666666666666666666666666660909090909
0909090909666666666666666666666666666666666666666666666666666666666666666666666666666666660909090909
0909090909666666666666666666666666666666666666666666666666666666666666666666666666666666660909090909
0909090909090966666666666666666666666666666666666666666666666666666666666666666666666666660909090909
0909090909090966666666666666666666666666666666666666666666666666666666666666666666666666660909090909
0909090909090966666666666666666666666666666666666666666666666666666666660909090909090909090909090909
0909090909090966666666666666666666666666666666666666666666666666666666660909090909090909090909090909
0909090909090966666666666666666666666666666666666666666666666666666666660909090909090909090909090909
0909090909090966666666666666666666666666666666666666666666666666666666660909090909090909090909090909
0909090909090966666666666666666666666666666666666666666666666666666666660909090909090909090909090909
0909090909090966666666666666666666666666666666666666666666666666666666660909090909090909090909090909
0909090909090966666666666666666666666666666666666666666666666666666666660909090909090909090909090909
0909090909090966666666666666666666666666666666666666666666666666666666660909090909090909090909090909
0909090909090909090909090909090909090909090909090909090909090909090909090909090909090909090909090909
0909090909090909090909090909090909090909090909090909090909090909090909090909090909090909090909090909
0909090909090909090909090909090909090909090909090909090909090909090909090909090909090909090909090909
@cave_drg_1+160+24+cave_drg_2+223+22+cave_drg_3+1152+23+cave_drg_4+1440+352+cave_drg_5+1152+606+cave_drg_6+224+861+cave_drg_7+160+542+chest+1358+408+chest+1357+540+