30+30!
090909090909090909090909090909090909090909090909090909090909
090909090909090909090909090909090909090909090909090909090909
090909090909090909090909090909090909090909090909090909090909
090909090909090909090909090909090909090909090909090909090909
090909090909090909090909090909090909090909090909090909090909
090909090909090909090909090909090909090909090909090909090909
090909090909090909090909090909090909090909090909090909090909
09090909090909030303030A0B0C03030303030303030309090909090909
09090909090909030303030A0B0C03030303030303030309090909090909
09090909090909030303030A0B0C03030303030303030309090909090909
090909090909096565656506070865656565030303030309090909090909
09090909090909030303030A0B0C03030303030303030309090909090909
09090909090909030303030A0B0C03030303030303030309090909090909
09090909090909030303030A0B0C03030303030303030309090909090909
09090909090909030303030A0B0C03030303030303030309090909090909
09090909090909030303030A0B0C03030303030303030309090909090909
09090909090909030303030A0B0C03030303030303030309090909090909
09090909090909030303030A0B0C03030303030303030309090909090909
09090909090909030303030A0B0C03030303030303030309090909090909
090909090909090909090909030909090909090909090909090909090909
090909090909090909090909090909090909090909090909090909090909
090909090909090909090909090909090909090909090909090909090909
090909090909090909090909090909090909090909090909090909090909
090909090909090909090909090909090909090909090909090909090909
090909090909090909090909090909090909090909090909090909090909
090909090909090909090909090909090909090909090909090909090909
090909090909090909090909090909090909090909090909090909090909
090909090909090909090909090909090909090909090909090909090909
090909090909090909090909090909090909090909090909090909090909
090909090909090909090909090909090909090909090909090909090909
@church_1_2+217+224+church_1_1+217+608+church_1_10+416+608+church_1_4+217+109+church_1_3+575+224+church_1_5+672+224+church_1_9+736+287+church_1_6+626+292+church_1_7+583+434+church_1_8+675+434+altar+367+277+organ+225+192+pew+246+361+pew+238+403+pew+235+454+pew+236+501+pew+245+543+pew+464+365+pew+469+415+pew+462+465+pew+469+519+pew+471+556+dining_table+658+488+dining_table+658+526+cross+383+183+church_chair1+352+203+church_chair1+417+201+kitchen_cabinet+704+269+oven+649+272+table_hut+685+351+