45+34!
090909090909090909090909090909090909090909090909090909090909090909090909090909090909090909
090000000018141010121600000000000000000000000000000000000000000000000000000000000000000009
090000000000181410101216000000000000000000000000000000000000000000000000000000000000000009
090000000000001814101012160000000000000000000000000000000000000000000000000000000000000009
090000000000000018141010121600000000000000000000000000000000000000000000000000000000000009
090000020202020202181A14101219160000000000000000000000000000000000000000000000000000000009
090002020202020202020018141010121916000000000000000000000000000000000000000000000000000009
0900020202020202020200001B1010101012160000000000000000000000000003030303030303030303030009
090051020202020202510000181410101010121916000000000000000000000303030303030303030303030309
090000510202020251000000001B10101010101012191600000000000000000303030303030303030303030309
090000005153515100003A3A3A1810101010101010101216000000000000005003030303060708030303035009
0900003A3730383A3A373030303004040404040404040404040440404040000050505250060708505250500009
090037303030303030303030303004040404040404040404040440404040400000000000000000000000000009
093730303030303030303030353905050505050505050505050500004040404040404040404040404040404009
093030303035393939393939001510101010101010101010101C00000040404040404040404040404040404009
093030303500000000000000151110101010101010101010101216000000404040404040404040404040404009
0930303038000000000000001B101010101010101010101010101C000000000040404040400000000000000009
093030303038000000000015111010101010101010101010101012160000000000004040404000000000000009
09363030303038000000001B1010101010101010101010101010101C0000000000000040404040000000000009
09003630303030380000001B101010101010101010101010101010121600000000000000404040400000000009
09000036303030303B001511101010101010101010101010101010101C00000000000000004040400000000009
09000000363030303B001B10101010101010101010101010101010131700000000000000004040400000000009
090000003C3030303B001B10101010101010101010101010101013170000000000000000004040400000000009
090000003C3030303B001814101010101010101010101010101317000000000000000000004040400000000009
090000003C3030303B000018141010101010101010101010131700000000000000000000004040400000000009
090000003C3030303B000000181A1A14101010101010131A170000000000000000000000004040400000000009
090000003C3030303B000000000000181A14101010131700000000000000000000000000004040400000000009
090000003C3030303B00000000000000001B1010101C0000000000000000000000000000004040400000000009
090000003C3030303B00000000000000001B101010121600000000000000000000000000004040400000000009
090000003C3030303B00000000000000001B101010101C00000000000000000000000000004040400000000009
090000003C3030303B000000000000000018141010101C00000000000000000000000000004040400000000009
090000003C3030303B0000000000000000001B1010101C00000000000000000000000000004040400000000009
090000003C3030303B0000000000000000001B1010101C00000000000000000000000000004040400000000009
090909090909090909090909090909090909090909090909090909090909090909090909090909090909090909
@tree_pine+200+400+tree_pine+200+440!