20+20!
0909090909090909090909090909090909090909
0909090909090909090909090909090909090909
0909090909090909090909090909090909090909
0909090909090909090909090909090909090909
0909090909090909090909090909090909090909
0909090909090909090909090909090909090909
0909090909090909090909090909090909090909
0909090909020202020202020909090909090909
0909090909020202020202020909090909090909
0909090909020202020202020909090909090909
0909090909020202020202020909090909090909
0909090909020202020202020909090909090909
0909090909090909020909090909090909090909
0909090909090909090909090909090909090909
0909090909090909090909090909090909090909
0909090909090909090909090909090909090909
0909090909090909090909090909090909090909
0909090909090909090909090909090909090909
0909090909090909090909090909090909090909
0909090909090909090909090909090909090909
@hut_1+152+224+hut_1+383+224+hut_2+160+384+hut_3+288+384+hut_5+152+170+hut_cheese+165+216+hut_grain+199+213+hut_counter+231+212+hut_oven+317+199+chair_front+199+238+chair_right+170+257+hut_table+183+259+bed_hut+303+296+barrel2+191+347+outcast_box1+163+340+